111111111111111111
100000000011000001
101111111011111101
101000001000000001
101011111111111101
100000000000000001
111111111111111111
