1111111111
1000000001
1011101101
1010000101
1011101101
1000000001
1111111111
