1111111111111111
1000000000000001
1011101111011101
1010001001000001
1010111011011101
1000000000000001
1111111111111111
